22 160
...........................................................................................................
...........................................................................................................
.........#.....#......####......#......#..........####.......#######.....########.....####.................
..........#...#.....#.....#.....#......#..........#....#........#........#............#....#...............
...........#.#.....#.......#....#......#..........#.....#.......#........#............#.....#..............
............#......#.......#....#......#..........#.....#.......#........########.....#.....#..............
............#......#.......#....#......#..........#.....#.......#........#............#.....#..............
............#.......#.....#......#....#...........#...#.........#........#............#...#................
............#.........####........####............####.......#######.....########.....####.................
...........................................................................................................
...........................................................................................................
